XXXXXXXXXXXXXXXXXXXX
XP      1          X
X XX XXX XX XXX XX X
X XX XXX XX XXX XX X
X        XX        X
X XXXXXXXXXXXXXXXX X
X        XX    2   X
X XX XXX XX XXX XX X
X XX XXX XX XXX XX X
X                  X
XXXXXXXXXXXXXXXXXXXX